111111111111111111111111111111
1P000000000000000000000000W101
111101111011101111101111011101
10010000100000001W00001W000001
1W11111W1111011101110111111101
10000001C00000001C000000000001
11110111010111111101111101W101
100000000001C00000000000000101
110111011111010111011111011101
1001W0000000C001C000000001W101
100111011101010111110111W11101
1C0000C10W000000000000C00CE001
111111111111111111111111111111