111111111111111111111111111111
1P0000000000000000000000000101
111101111011101111101111011101
100100001000000010000010000001
101111101111011101110111111101
10000001C00000001C000000000001
111101110101111111011111010101
100000000001C00000000000000101
110111011111010111011111011101
100100000000C001C0000000000101
100111011101010111110111011101
1C0000C100000000000000C00CE001
111111111111111111111111111111