1111111111111111
1000000000010001
1000000000010001
1P10111111100101
10000000E0000101
1001111111111001
1CCCCCCCCCCCCCC1
1111111111111111